Rk,Player,Age,G,GS,MP,FG,FGA,FG%,3P,3PA,3P%,2P,2PA,2P%,eFG%,FT,FTA,FT%,ORB,DRB,TRB,AST,STL,BLK,TOV,PF,PTS,Trp-Dbl,Awards
1,Wesley Johnson,27,76,59,2245,286,691,0.414,91,259,0.351,195,432,0.451,0.48,90,112,0.804,67,252,319,124,59,45,87,162,753,0,
2,Jeremy Lin,26,74,30,1907,277,654,0.424,65,176,0.369,212,478,0.444,0.473,213,268,0.795,26,170,196,339,82,32,166,189,832,0,
3,Jordan Hill,27,70,57,1874,357,777,0.459,3,11,0.273,354,766,0.462,0.461,124,168,0.738,174,382,556,103,34,52,106,164,841,0,
4,Ed Davis,25,79,24,1840,282,469,0.601,0,0,,282,469,0.601,0.601,92,189,0.487,230,370,600,94,49,98,58,202,656,0,
5,Carlos Boozer,33,71,26,1692,371,743,0.499,0,0,,371,743,0.499,0.499,94,150,0.627,111,371,482,95,41,12,92,184,836,0,
6,Wayne Ellington,27,65,36,1675,254,617,0.412,90,243,0.37,164,374,0.439,0.485,52,64,0.813,31,179,210,105,33,2,50,77,650,0,
7,Jordan Clarkson,22,59,38,1476,267,596,0.448,38,121,0.314,229,475,0.482,0.48,131,158,0.829,56,135,191,206,51,12,96,109,703,0,ROY-7
8,Ryan Kelly,23,52,34,1233,104,309,0.337,45,134,0.336,59,175,0.337,0.409,79,95,0.832,13,133,146,92,30,24,37,118,332,0,
9,Kobe Bryant,36,35,35,1207,266,713,0.373,54,184,0.293,212,529,0.401,0.411,196,241,0.813,26,173,199,197,47,7,128,65,782,2,AS
10,Robert Sacre,25,67,18,1133,126,306,0.412,0,1,0,126,305,0.413,0.412,55,82,0.671,89,144,233,55,28,43,36,121,307,0,
11,Nick Young,29,42,0,1000,174,476,0.366,83,225,0.369,91,251,0.363,0.453,132,148,0.892,17,79,96,41,23,11,44,83,563,0,
12,Ronnie Price,31,43,20,982,77,223,0.345,31,109,0.284,46,114,0.404,0.415,36,45,0.8,19,50,69,165,67,4,52,118,221,0,
13,Tarik Black,23,38,27,803,112,190,0.589,0,0,,112,190,0.589,0.589,50,89,0.562,84,157,241,34,13,22,29,102,274,0,
14,Jabari Brown,22,19,5,568,70,170,0.412,23,62,0.371,47,108,0.435,0.479,64,85,0.753,3,33,36,40,12,2,32,33,227,0,
15,Dwight Buycks,25,6,0,123,18,40,0.45,7,11,0.636,11,29,0.379,0.538,9,10,0.9,2,10,12,14,3,0,12,3,52,0,
16,Xavier Henry,23,9,0,86,3,13,0.231,0,0,,3,13,0.231,0.231,14,24,0.583,2,2,4,3,3,0,3,6,20,0,
17,Vander Blue,22,2,1,74,9,30,0.3,2,10,0.2,7,20,0.35,0.333,2,5,0.4,2,7,9,8,3,0,6,4,22,0,
18,Julius Randle,20,1,0,14,1,3,0.333,0,0,,1,3,0.333,0.333,0,2,0,0,0,0,0,0,0,1,1,2,0,
,Team Totals,,82,82,19932,3054,7020,0.435,532,1546,0.344,2522,5474,0.461,0.473,1433,1935,0.741,952,2647,3599,1715,578,366,1035,1741,8073,2,