Rk,Player,Age,G,GS,MP,FG,FGA,FG%,3P,3PA,3P%,2P,2PA,2P%,eFG%,FT,FTA,FT%,ORB,DRB,TRB,AST,STL,BLK,TOV,PF,PTS,Trp-Dbl,Awards
1,Dennis Schröder,29,66,50,1986,270,650,0.415,74,225,0.329,196,425,0.461,0.472,216,252,0.857,21,144,165,298,50,10,112,145,830,0,
2,LeBron James,38,55,54,1954,609,1219,0.5,121,377,0.321,488,842,0.58,0.549,251,327,0.768,65,392,457,375,50,32,178,88,1590,2,"AS,NBA3"
3,Anthony Davis,29,56,54,1904,542,962,0.563,19,74,0.257,523,888,0.589,0.573,348,444,0.784,195,507,702,148,59,114,122,146,1451,0,
4,Troy Brown Jr.,23,76,45,1860,200,465,0.43,107,281,0.381,93,184,0.505,0.545,34,39,0.872,62,246,308,95,59,16,49,120,541,0,
5,Austin Reaves,24,64,22,1843,259,490,0.529,86,216,0.398,173,274,0.631,0.616,229,265,0.864,33,160,193,215,33,19,99,108,833,0,6MOY-7
6,Russell Westbrook,34,52,3,1491,304,729,0.417,63,213,0.296,241,516,0.467,0.46,156,238,0.655,59,262,321,391,53,23,184,121,827,4,6MOY-9
7,Lonnie Walker IV,24,56,32,1297,236,527,0.448,91,249,0.365,145,278,0.522,0.534,91,106,0.858,14,95,109,64,30,17,46,71,654,0,
8,Patrick Beverley,34,45,45,1211,97,241,0.402,55,158,0.348,42,83,0.506,0.517,39,50,0.78,24,116,140,118,40,25,42,124,288,0,
9,Wenyen Gabriel,25,68,2,1024,155,260,0.596,10,36,0.278,145,224,0.647,0.615,52,84,0.619,116,170,286,36,26,35,46,144,372,0,
10,Thomas Bryant,25,41,25,876,197,301,0.654,22,50,0.44,175,251,0.697,0.691,80,108,0.741,67,212,279,29,14,23,28,77,496,0,
11,Rui Hachimura,24,33,9,738,126,260,0.485,21,71,0.296,105,189,0.556,0.525,44,61,0.721,34,121,155,23,8,14,17,33,317,0,
12,Jarred Vanderbilt,23,26,24,625,74,140,0.529,10,33,0.303,64,107,0.598,0.564,29,37,0.784,49,124,173,42,30,6,29,57,187,0,
13,Malik Beasley,26,26,14,621,105,268,0.392,66,187,0.353,39,81,0.481,0.515,13,21,0.619,8,78,86,31,21,1,30,32,289,0,
14,Kendrick Nunn,27,39,2,528,102,251,0.406,41,126,0.325,61,125,0.488,0.488,17,21,0.81,5,50,55,34,11,3,31,35,262,0,
15,D'Angelo Russell,26,17,17,526,107,221,0.484,46,111,0.414,61,110,0.555,0.588,36,49,0.735,7,43,50,103,10,8,39,23,296,0,
16,Max Christie,19,41,3,512,44,106,0.415,26,62,0.419,18,44,0.409,0.538,14,16,0.875,7,68,75,21,9,7,13,33,128,0,
17,Juan Toscano-Anderson,29,30,7,365,33,66,0.5,4,20,0.2,29,46,0.63,0.53,11,15,0.733,14,47,61,25,10,7,17,46,81,0,
18,Damian Jones,27,22,1,176,20,37,0.541,0,3,0,20,34,0.588,0.541,15,20,0.75,18,37,55,4,3,12,9,17,55,0,
19,Matt Ryan,25,12,0,129,15,49,0.306,13,35,0.371,2,14,0.143,0.439,4,5,0.8,2,12,14,4,2,0,3,14,47,0,
20,Mo Bamba,24,9,1,88,11,27,0.407,5,16,0.313,6,11,0.545,0.5,6,11,0.545,11,30,41,4,1,5,8,19,33,0,
21,Cole Swider,23,7,0,41,3,9,0.333,3,8,0.375,0,1,0,0.5,0,0,,1,6,7,4,0,0,0,3,9,0,
22,Scotty Pippen Jr.,22,6,0,32,4,12,0.333,1,3,0.333,3,9,0.333,0.375,5,9,0.556,2,2,4,2,2,1,2,3,14,0,
23,Davon Reed,27,8,0,27,3,4,0.75,1,2,0.5,2,2,1,0.875,1,4,0.25,1,3,4,4,2,0,0,3,8,0,
24,Sterling Brown,27,4,0,24,0,4,0,0,2,0,0,2,0,0,0,0,,3,5,8,2,3,0,0,4,0,0,
,Team Totals,,82,82,19878,3516,7298,0.482,885,2558,0.346,2631,4740,0.555,0.542,1691,2182,0.775,818,2930,3748,2072,526,378,1104,1466,9608,6,